NO ./assets/north.xpm
SO ./assets/south.xpm
EA ./assets/east.xpm
WE ./assets/west.xpm

F 220,100,1
C 225,30,1

        11111111111111111111111111
        1N000011011000000110010001
        100100110000000001 1000011
111111111011000001110000001000001
100000000011000001110111111111111
11110111111111011100000010001
11110111111111011101010010001
11000000110111011100000010001
1000000000000001100000010001111
10000000000000001101010010001
11000001110101011111011110011
11110111 11101011011110100011
11111111 1111111 111111111111








